"bcg","dtp","agem","dead","censored","n"
0,0,0,31,606,637
1,0,0,6,224,230
1,1,0,0,7,7
0,0,1,24,396,420
1,0,1,12,376,388
0,1,1,0,1,1
1,1,1,3,77,80
0,0,2,13,302,315
1,0,2,3,241,244
0,1,2,1,5,6
1,1,2,10,344,354
0,0,3,12,201,213
1,0,3,5,121,126
0,1,3,0,5,5
1,1,3,19,444,463
0,0,4,7,165,172
1,0,4,3,81,84
0,1,4,0,6,6
1,1,4,28,469,497
0,0,5,3,129,132
1,0,5,4,60,64
0,1,5,0,9,9
1,1,5,27,463,490
0,0,6,5,48,53
1,0,6,0,23,23
0,1,6,1,3,4
1,1,6,5,246,251
